755555555555555555558
311111111111111111114
312121212121212121214
311111111111111111114
312121212121212121214
311111111111111111114
312121212121212121214
311111111111111111114
312121212121212121214
311111111111111111114
312121212121212121214
311111111111111111114
312121212121212121214
311111111111111111114
312121212121212121214
311111111111111111114
312121212121212121214
311111111111111111114
312121212121212121214
311111111111111111114
966666666666666666660

DESTRUCTIBLE
000000000000000000000
000111111111111111000
000101010101010101000
011010101010101010110
010101010101010101010
011010101010101010110
010101010101010101010
011010101010101010110
010101010101010101010
011010101010101010110
010101010101010101010
011010101010101010110
010101010101010101010
011010101010101010110
010101010101010101010
011010101010101010110
010101010101010101010
011010101010101010110
000101010101010101000
000111111111111111000
000000000000000000000
END